29 19
11111111111111111111111111111
12222221111112222222222111111
11111121111122333333332111111
11111121111123333333332111111
11111121111122223333332111111
11111121111111123333332111111
11111121111111222233332111111
11111121111122233222332111111
11111121111123333333222111111
11111121111123333333332111111
12222222222223333333332111111
12111211111123322222222222211
12111222111122223333321111211
12111112111123333333321111211
12111112222222222333321111211
12111111111123332333321111211
12111111111123332333321112211
12222222222222222222222222111
11111111111111111111111111111
6
A 1 15 10
A 1 13 15
A 2 5 5
W 1 10 8
W 2 3 15
W 2 6 7
