43 15
1111111111111111111111111111111111111111111
1111111111111111111122211111111111111111111
1113333333333331111122211144441111144441111
1113333333333331111122211144444444444441111
1113333333333331111122211144444444444441111
1111111111111111111122211111111111111111111
1112222222222222222222222222222222222222111
1112222222222222222222222222222222222222111
1111111111111111111122211111111111111111111
1111444444444444411122211113333333333333111
1111444444444444411122211113333333333333111
1111444411111444411122211113333333333333111
1111111111111111111122211111111111111111111
1111111111111111111122211111111111111111111
1111111111111111111111111111111111111111111
10
A 1 3 3
A 1 12 4
A 2 37 12
A 2 27 11
W 1 2 7
W 1 2 8
W 2 38 7
W 2 38 8
B 1 4 11
B 2 36 4
