18 6
111111111111133311
122111111113333311
112222222211333311
111111111211133311
122222222222222211
111111111111111111
5
A 1 14 0
A 1 14 3
A 2 11 1
W 2 0 0
W 1 5 5
