18 6
111111111111133311
122211111113333311
112222222211333311
111111111211133311
122222222222222211
111111111111111111
2
W 2 1 0
W 1 1 1
