10 7
1111111111
1222222221
1233333321
1231111321
1233333321
1222222221
1111111111
4
A 1 5 5
A 2 7 2
W 1 1 3
W 2 4 6
