19 19
2222222222222222222
1111111111111111112
1222222222222222212
1211111111111111212
1212222222222221212
1212111111111121212
1212122222222121212
1212121111112121212
1212121222212121212
1212121214212121212
1212121212212121212
1212121211112121212
1212121222222121212
1212121111111121212
1212122222222221212
1212111111111111212
1212222222222222212
1211111111111111112
1222222222222222222
6
W 1 3 4
W 1 14 4
A 1 9 1
W 2 2 17
W 2 17 17
B 2 9 9
