18 6
444444444444433344
422444444443333344
442222222244333344
444444444244433344
422222222222222244
444444444444444444
5
A 1 14 0
A 1 14 3
A 2 11 1
W 2 1 1
W 1 5 4
