15 15
444444444444444
444444422224444
444222223324444
444233333324444
444222222224444
444444442444444
444444442444444
444444442444444
444444442444444
444444442444444
444422222222444
444423333332444
444423333222444
444422222244444
444444444444444
6
B 1 1 4
B 1 13 4
B 2 2 12
B 2 13 12
A 1 8 4
A 2 8 12
